11000000000000000000
01110000000000000000
00011110000000010000
00010010000000010000
00011010000000010000
00001001000000011100
00111000100000000100
00100000000000000100
00111111111111111100
00100000000000100000
00100000000000100000
01110000000000111100
00011110000000100100
00010010000000100100
00011011111111100100
00001001000000000000
00111001111111100000
00100000010000100000
00110000011000111900
00000000000000000000