00000000000100000000
01110000000100000000
00011110000100010000
00010010001100010000
00011010001100010000
00001001000000011100
00111000100000000100
00100000000000000100
00111111111111111100
00100000000000100000
00100000000000100000
01110000001111111100
00011110000000100100
00010010000000100100
00011011111111100100
00001001000000000000
00111001111111100000
00100000010000100000
00110000011000111000
00000110000000000000